###############################################################################
#s  #   #     #   #     $       #    $    #       #     #   # ^$    #     # $ #
###     # # # ### # ####### ### ####### # # #####$# ### # # # # ### ### # #$# #
# #       # #   # #   #     #      $    # # # ^ #   #   # #  $# # #     # # # #
# ##    ### ### # ###$# ### ############# # # ####### ######### # #######$### #
#   # #$  #   # #   $ #   # # ^ #$          # $     #      $    #     # $ #   #
# # # # ##### # ##### ### ### # #############$##### ############# ### #$### ###
# #  $# #     #   $ #   # #   #$            #     #      $    #     # # #     #
# ##### # ######### ### # # ###############$##### ######### ### ### ### # ###^#
#  $# # # #     #   #   # #  $  #       # $ #   # #    $  #   # # # #^  # # # #
### # # # ### ### ### ### ##### # ##### #$### # # ##### # ###^# # #$# ### # # #
#$  # # #   # #   # #   #  $    # #     #     # #    $# # #   #   # #   #   # #
# ### # ### #$# ### ### ######### # ###########f##### ### # # ###$# ### ### # #
# # #     # # # #     # #$    #   # #^$     #   #  $#   # # #   # #   #   # #$#
# # # ##### # # # ### # ### #^### # ##### ### ### ##### # # ##### ### ### ### #
# #   #   # # # #   #^#$    #     # #   # #   #  $    #   # # $     #   #  $# #
# ##### # # #^# ##### # ###########$# # # # ##### # ##### # #$######### ### # #
#   #^  #   # # #   #$  #       # $   #   #    $# # #     # $ # #       #$  # #
### # ####### # # # ##### ##### ####### ####### # # # ######### # ####### ### #
#   # #       #   #$    #   # # $   #   #    $  # # #     # ^ # #   #  $#     #
# ###$# # ############# ### # ##### ##### ####### # #####$# # # ### # # ##### #
#   $ # #        $          # $           #$^     #     $   #     #  $#       #
###############################################################################
