#################
#s  ####^# #    #
## ####         #
#  ## ## ## $   #
##  ^^   ## $ f #
#################
